#########
#       #
# #####.#
#   #####
##    ###
####  ###
#### ####
#@##$####
#  B ####
#########
;
#######
#.    #
### ###
#     #
# $@$ #
#     #
#######
;
 ########
##      #
#   .   #
#   $   #
# .$@$. #
####$   #
   #.   #
   #   ##
   #####